reflector-1
	dc.b %11000000
	dc.b %11000000
	dc.b %00100000
	dc.b %00010000
	dc.b %00001000
	dc.b %00000100
	dc.b %00000011
	dc.b %00000011

reflector-2
	dc.b %00000011
	dc.b %00000011
	dc.b %00000100
	dc.b %00001000
	dc.b %00010000
	dc.b %00100000
	dc.b %11000000
	dc.b %11000000

laser_receptor
	dc.b %11111111
	dc.b %00111100
	dc.b %00011000
	dc.b %00000000
	dc.b %00000000
	dc.b %00000000
	dc.b %00000000
	dc.b %00000000

3_V
	dc.b %00000000
	dc.b %00100010
	dc.b %00100010
	dc.b %00100010
	dc.b %00100010
	dc.b %00100010
	dc.b %00010100
	dc.b %00001000

5_top_wall
	dc.b %00000000
	dc.b %00000000
	dc.b %00000000
	dc.b %00000000
	dc.b %00000000
	dc.b %00000000
	dc.b %00000000
	dc.b %11111111

5_right_wall
	dc.b %10000000
	dc.b %10000000
	dc.b %10000000
	dc.b %10000000
	dc.b %10000000
	dc.b %10000000
	dc.b %10000000
	dc.b %10000000

5_bottom_wall
	dc.b %11111111
	dc.b %00000000
	dc.b %00000000
	dc.b %00000000
	dc.b %00000000
	dc.b %00000000
	dc.b %00000000
	dc.b %00000000

5_left_wall
	dc.b %00000001
	dc.b %00000001
	dc.b %00000001
	dc.b %00000001
	dc.b %00000001
	dc.b %00000001
	dc.b %00000001
	dc.b %00000001

